NO ./texture/north_texture.xpm
SO ./texture/south_texture.xpm
WE ./texture/west_texture.xpm
EA ./texture/east_texture.xpm

F 220,100,0
C 225,30,0


11111111111               111111111111111
111111111111111111111111111111111
11111111111111111111111111111111111111111
111100000000000000000000000000000000000011111111111111111
1100000000000000000000000000000000000000000000000011111111111111
11111111000000000000000000000000000000000000011111111111111111111111
11000000000000000000000000000000000000000000000000000011111111111111
11111000001111111111111111110000000000000000110000000000001
1110000000000000000000000000000000000000000000000011111111111111
111110000000000000000000000000000000000000000000011
111111111111111111111111110000000000000000001111111111
11111110000000000000000000000000000000000011
1111000000000000001111111111111111000111111
111000000000000000000000000000000000000001111
1111111000000000000000000000000000000001111111
10000000000000000000000000000000000000000000011111111111111
1100000000000000000000000000000000000000000000000000001111111
11111111111100000000000000000000000000000001111111111111111111111
11111111111111111111111N111111111111100000000000000000000000000001
11000000000000000000000000000000000000000000000000000000000000000011
111111111111111111111111111111111111111111111111111111111111111111111
1111                                                          11111111111