NO ./texture/north_texture.xpm
SO ./texture/south_texture.xpm
WE ./texture/west_texture.xpm
EA ./texture/east_texture.xpm

C  200,50,0
F  200,140,50                      

    111111111111111111111111                        
    111111111111111111111111111111111111111111
1 11110000100000000N000000011110100000001111
111   11111100010000000000001111111111111111
111111111111111111111111111111111111111111



