NO ./textures/north.xpm
SO ./textures/south.xpm
WE ./textures/west.xpm
EA ./textures/east.xpm

F 220,100,0
C 135,206,235

11111111111111111
10000000000000001
10000000000000001
10000000000000001
10001111111000001
10001000001000001
10001000001000001
10001011101000001
10000000000000001
10000N00000000001
10000000000000001
11111111111111111
